#,#,#,#,#,#
#,w,w,w,w,#
#,w,w,w,w,#
#,#,r,#,#,#
#,w,w,w,w,#
#,#,#,#,#,#
