#,#,s,#,#,#
#,l,l,l,l,#
#,l,l,l,l,#
#,#,s,l,#,#
#,l,l,l,l,#
#,#,#,s,#,#
