#,#,#,r,r,r
#,#,#,r,w,r
#,#,#,r,r,r
r,r,#,#,#,r
r,w,#,#,#,r
r,w,#,#,#,r
r,r,r,r,r,r
