#,s,#,s,#,s,#,s,#
s,#,s,#,s,#,s,#,s
l,l,l,l,l,l,l,l,l
s,s,#,#,s,s,#,#,s
s,#,#,s,s,s,#,#,s
l,l,l,l,l,l,l,l,l
l,l,l,l,l,l,l,l,l
