#,#,#,s,#,#,#,#,#
s,#,#,#,#,#,#,#,#
l,l,l,l,l,l,l,l,l
#,#,#,#,#,#,#,#,s
#,#,#,#,s,#,#,#,#
l,l,l,l,l,l,l,l,l
l,l,l,l,l,l,l,l,l
