#,#,s,#,#,#
#,w,w,w,w,#
#,w,w,w,w,#
#,#,r,l,#,#
#,w,w,w,w,#
#,#,#,s,#,#
