#,#,#,#,#,r,r,r,r
#,#,#,#,#,r,w,w,r
#,#,#,#,#,r,w,w,r
#,#,#,#,#,r,w,w,r
r,r,r,r,#,r,r,r,r
r,w,w,r,#,#,#,#,r
r,w,w,r,#,#,#,#,r
r,w,w,r,#,#,#,#,r
r,r,r,r,r,r,r,r,r
